You: find some notable new YC backed companies and describe their similarities in an applicable way for software startup founders
[info] [2025-06-24T14:55:04.276Z] Received request for tool: firecrawl_search
[info] Request completed in 6665ms

Agent: Based on the information gathered from various sources, some notable new YC-backed companies include:

- Flock Safety: Public safety operating system, Series F funding, $7.5B valuation.
- Camber: Healthcare payments platform, Series B funding, $80M valuation.
- HighTouch.io: Customer data sync platform, Series C funding, $1.2B valuation.
- Qventus: Hospital decision optimization, Series D funding, $85M valuation.
- Astranis: Space telecommunications satellites, Series D funding, $1.4B valuation.
- Vanta: Automated security monitoring, Series C funding, $2.5B valuation.
- Embark Trucks: Self-driving trucks, acquired by GM, notable for coast-to-coast autonomous drive.
- Lucira Health: Portable health diagnostics, Series B funding.
- Momentus: Space infrastructure services, Series D funding, $1.4B valuation.
- Segment: Customer data platform, acquired, Series E funding.
- Algolia: Search API, Series D funding, $184M valuation.
- Rippling: HR, IT, and finance platform, Series F funding, $13.5B valuation.
- Razorpay: Indian payments platform, Series F funding, $7.5B valuation.
- Deel: Global HR and payroll, Series B funding, $1.2B valuation.
- WePay: Payments API, acquired by JPMorgan Chase.
- Podium: Customer communication platform, Series D funding.
- Rappi: Latin American delivery marketplace, Series B funding.
- Webflow: No-code web development, Series D funding.
- Zapier: Workflow automation, Series C funding.
- Zepto: Rapid grocery delivery in India, Series E funding.

**Similarities and applicable insights for software startup founders:**

1. **Focus on Niche Markets:** Many of these YC-backed companies serve specific verticals like healthcare, space, logistics, or local commerce, indicating that targeting niche markets with tailored solutions can be highly successful.

2. **Leverage Technology for Automation:** Companies like Vanta, Segment, and Rippling emphasize automation and integration, reducing manual work and increasing efficiencyâ€”key for scaling SaaS products.

3. **Scalability and Network Effects:** Platforms like Rappi, Razorpay, and Webflow demonstrate the power of network effects and scalable infrastructure, enabling rapid growth and market dominance.

4. **Innovate in Traditional Industries:** Many startups are transforming legacy industries (e.g., space, construction, healthcare) with modern software, showing that innovation in established sectors can create significant value.

5. **Strong Funding and Valuations:** These companies often secure large funding rounds early, reflecting investor confidence in innovative business models and large addressable markets.

6. **Global and Local Strategies:** Some startups focus on local markets (India, Latin America), while others aim for global reach, highlighting the importance of understanding regional needs and scaling accordingly.

7. **Customer-Centric Design:** Many successful YC companies prioritize user experience, whether through intuitive interfaces or tailored solutions, which is crucial for adoption and retention.

Would you like a more detailed analysis of specific companies or sectors?

